1111111111111111
100N000000000001
1000000000000001
1000000100000001
1000000100000001
1000000100000001
1000000100000001
1000011111000001
1000000000000001
1111111111111111
