1111111111111111
1000000000000011
1011111010000001
1000000100000001
1000000100000001
1000000100000001
1000000100000001
1000011111000001
1000000000000001
1111111111111111